,index,startTime,endTime,holdingTime,interval,changeAmount,accumAmount,drink
0,0,22,24,2,22,0,0,False
1,1,26,43,17,2,227,0,False
2,2,45,46,1,2,-227,227,True
3,3,54,57,3,8,171,227,False
4,4,66,70,4,9,-171,398,True
5,5,76,77,1,6,0,398,False
6,6,104,107,3,27,151,398,False
7,7,140,141,1,33,-151,549,True
8,8,184,187,3,43,121,549,False
9,9,314,319,5,127,-121,670,True
